1,1,1,1,1,1,1,1,1,1
14,1,1,1,1,1,1,1,1,12
14,1,0,1,1,1,1,1,1,12
14,1,1,1,1,1,1,1,1,12
14,1,1,1,1,1,1,1,1,12
14,1,0,1,1,1,0,1,1,12
14,1,1,1,1,1,1,1,1,12
14,1,1,1,1,1,1,1,1,12
14,1,1,0,1,1,1,1,1,12
1,1,1,1,1,1,1,1,1,1